R 800 600
NO     ./pictures/eagle.png
SO ./pictures/redbrick.png
WE ./pictures/greystone.png
EA ./pictures/wood.png


F  0 , 0 ,0
  
C  0,0,50  
     
S ./pictures/pillar.png


11111111111111111111111111
10000000001100000000000001
10011000001100000201100011
102100000000000200011000111111111
111111111011000001110000000000001
102000000011000001110111111111111
11110111111111011100000010001
01110111111111011101010010001
1100S000000001011100000012001
10002000000000001100000000001
10000000000002001101010010001
11111111020000011110111100111
1000000000000001 101111010001
1111111111111111 111111111111
