R   500 500
NO     ./pictures/bluestone.png
SO ./pictures/mossy.png
WE ./pictures/greystone.png
EA ./pictures/wood.png


F  0,0,0     
C  0,0,50    

     
S ./pictures/pillar.png

111111111111
100000000001
100000000001
100200000001111111111
100000000000000000001     
100000000001111111001
100000020001    11001
100020000001    10001
100000000001111111001
111111110000200000011
       1000000000011
       100000000001
       10000N000001
       111111111111




