R 2147483641111111 480123123121111111
NO     ./pictures/purple stone.png
SO ./pictures/redbrick.png
WE ./pictures/greystone.png
EA ./pictures/wood.png


F  0 , 0 ,0
  
C  0,0,50  
     
S ./pictures/pillar.png


11111111111111111111111111
10000000001100000000000001
100110000011100000201100011
1021000000000N0000011000111111111
111111111011000001110000000000001
102000000011000001110111111111111
11110111111111011100000010001
01110111111111011101010010001
11000000110101011100000012001
10002000000000001100000000001
10000000000000001101010010001
11000001111010111110111100111
11110111 1110101 101111010001
11111111 1111111 111111111111
