R   1920 1080
NO     ./pictures/wallpaper1.png
SO ./path_to_the_south
WE ./path_to_the_west
EA ./path_to_the_east

S ./path_to_sprite
F  0,0,0     
C  0,0,50    

111111111111
100000000001
100000200001
100000000001111111111
100222000000000000001     
100202000001111111001
100222000001    11001
100000000001    10001
100000200001111111001
111111110000000000011
       1000000000011
       100000000001
       10000N000001
       111111111111

