R  1010 1000
NO     ./pictures/purplestone.png
SO ./pictures/redbrick.png
WE ./pictures/greystone.png
EA ./pictures/wood.png


F  0 , 0 ,0
  
C  0,0,50  
     
S ./pictures/pillar.png


1111111111111111111111111
1000000000110000000111011
1011000001110000020110001
102100000000000000011000111111111
111111111011000001110000000000001
100000000011000001110111111111111
11110111111111011100000010001
11110111111111011101010010001
11000000110101011100000012001
10002000000000001100000000001
10000000000000001101010010001
110000011101010111110111100111
11110111 1110101 10111101N001
11111111 1111111 111111111111


