R   1920 1080
NO     ./path_to_the_north
SO ./path_to_the_south
WE ./path_to_the_west
EA ./path_to_the_east

S ./path_to_sprite
F       220   ,100,0     
C   220,0,0    

111111111111
100000000001
100000000001
100000000001
100222000001
100202000001
100222000001
100000000001
10000E000001
100000000001
100222000001
100000000001
100000000001
111111111111