R  1010 1000
NO     ./pictures/purplestone.png
SO ./pictures/redbrick.png
WE ./pictures/greystone.png
EA ./pictures/wood.png


F  0 , 0 ,0
  
C  0,0,50  
     
S ./pictures/pillar.png


111111111111
100000000001
100000000001
100200000001111111111
100000000000000000001     
100000000001111111001
100000020001    11001
1000200000111   10001
10000000N000111111101
111111110000200000011
       1000200000011
       100000000001
       100000000001
       111111111111


